NewRoom 8
0 0 1 0 0 0 0 0 
0 0 1 0 0 0 0 0 
0 0 1 1 1 1 0 0 
0 0 0 0 0 1 0 0 
0 0 0 0 0 1 0 0 
0 0 0 0 0 0 1 1 

22 0 0 0 0 0 0 30 
30 0 0 0 0 0 100 0 
0 0 0 0 0 0 80 91 
0 0 0 0 0 0 80 92 
0 0 0 0 0 0 50 0 
0 0 0 0 0 21 0 0 

0 0 0 0 0 0 0 0 
0 0 0 0 0 0 0 0 
0 0 0 0 0 0 0 0 
0 0 0 0 0 0 0 0 
0 0 0 0 0 0 0 0 
0 0 0 0 0 0 0 0 
