NewRoom 9
1 1 0 0 0 0 1 0 
0 1 1 1 1 1 1 0 
0 0 0 0 0 0 0 0 
0 0 0 0 0 0 0 0 
0 1 1 1 1 1 1 0 
1 1 0 0 0 0 1 0 

0 0 40 50 0 0 0 42 
0 0 0 0 0 0 0 0 
0 0 100 0 0 100 100 0 
0 0 100 0 0 0 100 0 
0 0 0 0 0 0 0 0 
0 0 42 50 0 0 0 40 

0 0 0 0 0 0 0 0 
0 0 0 0 0 0 0 0 
0 0 0 0 0 0 0 0 
0 0 0 0 0 0 0 0 
0 0 0 0 0 0 0 0 
0 0 0 0 0 0 0 0 
