NewRoom 9
0 0 0 0 0 0 0 0 
1 1 1 1 1 1 1 1 
0 0 0 1 0 0 0 0 
0 0 0 1 0 0 0 0 
1 1 1 1 1 1 1 1 
0 0 0 0 0 0 0 0 

0 30 0 0 0 0 0 40 
0 0 0 0 0 0 0 0 
0 0 40 0 91 92 0 50 
0 30 0 0 91 92 21 0 
0 0 0 0 0 0 0 0 
0 30 0 22 0 0 0 0 

0 0 0 0 0 0 0 0 
0 0 0 0 0 0 0 0 
0 0 0 0 0 0 0 0 
0 0 0 0 0 0 0 0 
0 0 0 0 0 0 0 0 
0 0 0 0 0 0 0 0 
