NewRoom 2
0 1 0 0 0 1 0 0 
0 1 0 0 0 0 1 0 
0 0 0 1 0 0 0 0 
0 0 0 0 0 0 0 0 
0 1 1 1 1 1 0 0 
0 0 0 0 0 0 0 0 

80 0 0 80 0 0 0 80 
0 0 0 80 0 80 0 50 
0 80 0 0 0 80 0 0 
0 80 80 80 80 80 80 0 
0 0 0 0 0 0 20 10 
0 80 80 80 80 80 10 10 

0 0 0 0 0 0 0 0 
0 0 0 0 0 0 0 0 
0 0 0 0 0 0 0 0 
0 0 0 0 0 0 0 0 
0 0 0 0 0 0 0 0 
0 0 0 0 0 0 0 0 
