NewRoom 10
0 0 0 0 0 0 0 1 
0 0 1 0 0 1 1 1 
0 1 1 1 1 1 1 1 
0 1 1 1 1 1 1 1 
0 0 1 0 0 0 0 0 
0 0 1 0 0 0 0 0 

0 0 80 0 0 80 40 0 
0 0 0 0 0 0 0 0 
0 0 0 0 0 0 0 0 
0 0 0 0 0 0 0 0 
80 0 0 0 0 0 0 0 
80 40 0 0 0 50 0 0 

0 0 0 0 0 0 0 0 
0 0 0 0 0 0 0 0 
0 0 0 0 0 0 0 0 
0 0 0 0 0 0 0 0 
0 0 0 0 0 0 0 0 
0 0 0 0 0 0 0 0 
