NewRoom 9
0 0 1 0 0 0 0 0 
0 0 1 0 0 1 1 1 
0 0 1 1 1 1 0 0 
0 0 1 1 1 1 0 0 
1 1 1 0 0 1 0 0 
0 0 0 0 0 1 0 0 

30 0 0 0 0 110 0 0 
0 0 0 0 30 0 0 0 
0 0 0 0 0 0 0 0 
0 0 0 0 0 0 0 0 
0 0 0 30 0 0 0 0 
50 0 0 0 0 0 0 30 

0 0 0 0 0 0 0 0 
0 0 0 0 0 0 0 0 
0 0 0 0 0 0 0 0 
0 0 0 0 0 0 0 0 
0 0 0 0 0 0 0 0 
0 0 0 0 0 0 0 0 
