NewRoom 11
0 0 0 1 1 0 0 0 
1 0 0 0 0 0 0 0 
0 0 0 0 0 0 0 0 
0 0 1 0 0 1 1 0 
0 0 0 0 0 1 1 1 
0 1 1 0 0 0 0 0 

0 0 0 0 0 0 0 90 
0 80 0 80 80 0 0 0 
0 80 50 40 80 90 90 0 
0 80 0 0 80 0 0 0 
0 80 80 0 80 0 0 0 
0 0 0 0 0 80 40 0 

0 0 0 0 0 0 0 0 
0 0 0 0 0 0 0 0 
0 0 0 0 0 0 0 0 
0 0 0 0 0 0 0 0 
0 0 0 0 0 0 0 0 
0 0 0 0 0 0 0 0 
