NewRoom 12
0 0 1 0 0 1 0 0 
0 0 1 1 0 1 1 1 
0 0 1 0 0 0 1 0 
0 1 1 0 0 0 1 0 
1 1 1 1 1 1 1 1 
1 0 0 0 0 0 0 0 

80 80 0 0 0 0 0 0 
80 0 0 0 40 0 0 0 
0 0 0 80 50 80 0 0 
0 0 0 50 90 50 0 0 
0 0 0 0 0 0 0 0 
0 40 0 0 0 0 0 0 

0 0 0 0 0 0 0 0 
0 0 0 0 0 0 0 0 
0 0 0 0 0 0 0 0 
0 0 0 0 0 0 0 0 
0 0 0 0 0 0 0 0 
0 0 0 0 0 0 0 0 
