NewRoom 5
0 0 0 0 0 0 0 0 
0 0 0 0 1 0 0 0 
0 0 0 1 1 0 0 0 
0 0 0 0 1 1 1 0 
1 1 1 0 0 1 0 0 
0 0 0 0 0 0 0 0 

80 80 80 80 0 0 0 0 
40 0 0 0 0 0 0 0 
0 80 90 0 0 0 0 0 
0 80 0 0 0 0 0 90 
0 0 0 110 0 0 0 50 
80 0 0 0 0 80 0 40 

0 0 0 0 0 0 0 0 
0 0 0 0 0 0 0 0 
0 0 0 0 0 0 0 0 
0 0 0 0 0 0 0 0 
0 0 0 0 0 0 0 0 
0 0 0 0 0 0 0 0 
