NewRoom 3
0 0 0 0 0 0 1 0 
0 0 0 0 0 0 1 1 
1 1 1 1 1 1 1 1 
1 1 1 1 1 1 1 1 
0 0 0 0 0 0 0 0 
0 0 0 1 0 0 0 0 

0 0 0 0 0 0 0 0 
0 40 0 0 0 0 0 0 
0 0 0 0 0 0 0 0 
0 0 0 0 0 0 0 0 
0 80 80 80 80 0 0 0 
40 0 0 0 0 50 0 20 

0 0 0 0 0 0 0 0 
0 0 0 0 0 0 0 0 
0 0 0 0 0 0 0 0 
0 0 0 0 0 0 0 0 
0 0 0 0 0 0 0 0 
0 0 0 0 0 0 0 0 
