NewRoom 9
0 0 1 0 0 1 0 0 
0 0 1 0 0 1 0 0 
0 0 1 0 0 1 0 0 
0 0 1 0 0 1 0 0 
0 0 1 0 0 1 0 0 
0 0 1 0 0 1 0 0 

30 0 0 0 0 0 40 30 
0 0 0 0 90 0 0 0 
0 110 0 0 90 0 0 10 
0 0 0 0 0 0 0 20 
0 0 0 50 90 0 0 0 
30 40 0 0 0 0 0 30 

0 0 0 0 0 0 0 0 
0 0 0 0 0 0 0 0 
0 0 0 0 0 0 0 0 
0 0 0 0 0 0 0 0 
0 0 0 0 0 0 0 0 
0 0 0 0 0 0 0 0 
