NewRoom 5
0 0 0 0 0 1 1 1 
1 1 0 0 0 0 0 0 
0 0 0 1 1 0 0 0 
0 0 1 0 0 0 0 0 
1 1 1 1 0 0 1 0 
0 0 1 0 0 0 0 0 

50 0 80 0 0 0 0 0 
0 0 80 0 0 0 0 40 
0 30 80 0 0 80 80 80 
0 0 0 0 0 0 0 50 
0 0 0 0 80 80 0 80 
0 0 0 0 0 0 0 50 

0 0 0 0 0 0 0 0 
0 0 0 0 0 0 0 0 
0 0 0 0 0 0 0 0 
0 0 0 0 0 0 0 0 
0 0 0 0 0 0 0 0 
0 0 0 0 0 0 0 0 
