NewRoom 7
1 1 0 0 0 1 0 0 
1 0 0 1 0 1 0 0 
0 0 1 1 0 1 0 0 
0 1 1 1 1 1 0 0 
0 0 1 0 1 1 1 0 
1 1 0 0 0 1 0 0 

0 0 30 0 0 0 80 0 
40 30 0 0 40 0 80 0 
0 0 0 0 0 0 80 0 
0 0 0 0 0 0 80 0 
30 0 0 0 0 0 80 0 
0 0 0 30 50 0 0 0 

0 0 0 0 0 0 0 0 
0 0 0 0 0 0 0 0 
0 0 0 0 0 0 0 0 
0 0 0 0 0 0 0 0 
0 0 0 0 0 0 0 0 
0 0 0 0 0 0 0 0 
