NewRoom 10
0 0 1 1 0 0 1 0 
0 1 0 0 1 1 1 0 
0 0 0 0 1 0 0 0 
0 1 0 1 1 1 1 1 
0 1 0 0 1 0 1 1 
1 1 1 0 0 0 0 1 

40 80 0 0 0 0 0 0 
0 0 0 30 0 0 0 0 
50 30 0 0 0 0 0 30 
0 0 0 0 0 0 0 0 
80 0 30 0 0 0 0 0 
0 0 0 0 0 30 40 0 

0 0 0 0 0 0 0 0 
0 0 0 0 0 0 0 0 
0 0 0 0 0 0 0 0 
0 0 0 0 0 0 0 0 
0 0 0 0 0 0 0 0 
0 0 0 0 0 0 0 0 
