NewRoom 8
0 1 1 0 0 0 0 0 
0 0 1 0 0 0 0 0 
0 0 1 1 1 1 0 0 
0 0 1 0 0 0 1 1 
0 0 0 0 0 1 0 1 
0 0 1 0 0 0 0 0 

40 0 0 0 0 0 0 0 
0 90 0 0 0 0 0 0 
0 90 0 0 0 0 0 0 
0 0 0 0 30 90 0 0 
0 0 110 0 0 0 0 0 
80 0 0 0 50 90 80 40 

0 0 0 0 0 0 0 0 
0 0 0 0 0 0 0 0 
0 0 0 0 0 0 0 0 
0 0 0 0 0 0 0 0 
0 0 0 0 0 0 0 0 
0 0 0 0 0 0 0 0 
