NewRoom 8
0 0 1 0 0 0 0 0 
1 0 1 0 0 0 1 1 
1 1 1 0 0 0 0 0 
0 1 0 0 1 0 1 1 
0 1 0 0 0 0 0 0 
0 1 0 0 0 0 0 0 

0 0 0 0 0 0 0 0 
0 40 0 80 80 80 0 0 
0 0 0 50 40 0 0 0 
0 0 80 80 0 80 0 0 
0 0 0 0 20 10 0 0 
0 0 0 0 0 10 0 0 

0 0 0 0 0 0 0 0 
0 0 0 0 0 0 0 0 
0 0 0 0 0 0 0 0 
0 0 0 0 0 0 0 0 
0 0 0 0 0 0 0 0 
0 0 0 0 0 0 0 0 
