NewRoom 4
0 0 1 0 0 1 0 0 
0 0 0 0 0 1 0 0 
0 0 1 0 0 0 0 0 
0 0 0 1 1 0 0 0 
0 0 0 1 1 1 0 0 
0 0 0 0 0 0 0 0 

30 0 0 0 0 0 0 40 
0 0 80 50 0 0 110 0 
0 0 0 90 90 0 0 0 
0 40 0 0 0 0 80 0 
0 0 0 0 0 0 90 0 
0 0 0 0 0 0 90 80 

0 0 0 0 0 0 0 0 
0 0 0 0 0 0 0 0 
0 0 0 0 0 0 0 0 
0 0 0 0 0 0 0 0 
0 0 0 0 0 0 0 0 
0 0 0 0 0 0 0 0 
