NewRoom 9
0 1 0 0 0 1 1 0 
0 1 1 1 1 0 0 0 
0 1 1 0 1 0 1 0 
0 0 1 1 1 0 1 1 
1 0 0 0 1 1 1 1 
1 0 0 0 0 0 1 1 

0 0 0 0 0 0 0 0 
0 0 0 0 0 80 10 0 
0 0 0 40 0 50 0 0 
0 80 0 0 0 0 0 0 
0 80 0 0 0 0 0 0 
0 80 0 0 0 40 0 0 

0 0 0 0 0 0 0 0 
0 0 0 0 0 0 0 0 
0 0 0 0 0 0 0 0 
0 0 0 0 0 0 0 0 
0 0 0 0 0 0 0 0 
0 0 0 0 0 0 0 0 
