NewRoom 7
0 0 0 0 0 0 0 0 
0 0 0 0 0 0 0 0 
0 0 0 0 0 0 0 0 
0 0 1 0 1 0 0 0 
0 0 0 0 0 0 0 0 
0 0 1 0 1 0 0 0 

0 0 0 0 0 0 0 0 
90 0 0 0 0 0 0 90 
0 90 0 0 0 0 90 50 
0 90 0 42 0 0 90 0 
90 0 41 60 41 0 0 90 
0 0 0 42 0 0 0 0 

0 0 0 0 0 0 0 0 
0 0 0 0 0 0 0 0 
0 0 0 0 0 0 0 0 
0 0 0 0 0 0 0 0 
0 0 0 0 0 0 0 0 
0 0 0 0 0 0 0 0 
