NewRoom 7
0 0 0 0 0 0 0 0 
0 0 0 0 0 0 0 0 
0 0 0 0 0 0 0 0 
0 0 1 0 1 0 0 0 
0 0 0 0 0 0 0 0 
0 0 1 0 1 0 0 0 

0 0 0 0 0 0 0 0 
100 0 0 0 0 0 0 100 
0 100 0 0 0 0 100 50 
0 100 0 42 0 0 100 0 
100 0 41 70 41 0 0 100 
0 0 0 42 0 0 0 0 

0 0 0 0 0 0 0 0 
0 0 0 0 0 0 0 0 
0 0 0 0 0 0 0 0 
0 0 0 0 0 0 0 0 
0 0 0 0 0 0 0 0 
0 0 0 0 0 0 0 0 
