NewRoom 11
0 0 0 0 0 1 0 0 
0 0 0 0 0 1 0 0 
0 1 1 1 1 1 0 0 
0 1 1 0 0 1 0 0 
0 0 1 0 0 1 0 0 
0 0 1 0 0 1 0 0 

40 50 70 0 0 0 0 0 
80 0 80 0 0 0 0 0 
0 0 0 0 0 0 70 0 
0 0 0 0 30 0 70 0 
0 0 0 0 0 0 90 40 
70 20 0 0 0 0 70 0 

0 0 0 0 0 0 0 0 
0 0 0 0 0 0 0 0 
0 0 0 0 0 0 0 0 
0 0 0 0 0 0 0 0 
0 0 0 0 0 0 0 0 
0 0 0 0 0 0 0 0 
