NewRoom 11
0 0 0 0 0 1 0 0 
0 0 0 0 0 1 0 0 
0 1 1 1 1 1 0 0 
0 1 1 0 0 1 0 0 
0 0 1 0 0 1 0 0 
0 0 1 0 0 1 0 0 

40 50 80 0 0 0 0 0 
90 0 90 0 0 0 0 0 
0 0 0 0 0 0 90 0 
0 0 0 0 30 0 90 0 
0 0 0 0 0 0 100 40 
80 20 0 0 0 0 80 0 

0 0 0 0 0 0 0 0 
0 0 0 0 0 0 0 0 
0 0 0 0 0 0 0 0 
0 0 0 0 0 0 0 0 
0 0 0 0 0 0 0 0 
0 0 0 0 0 0 0 0 
