NewRoom 11
0 0 1 0 0 1 0 0 
0 0 1 0 0 1 0 0 
0 0 1 0 0 1 0 0 
0 0 1 0 0 1 0 0 
0 0 1 0 0 1 0 0 
0 0 1 0 0 1 0 0 

62 61 0 50 0 0 92 0 
0 0 0 93 93 0 93 92 
0 0 0 93 0 0 93 0 
0 0 0 93 93 0 92 0 
0 0 0 93 0 0 92 92 
63 0 0 0 0 0 91 92 

0 0 0 0 0 0 0 0 
0 0 0 0 0 0 0 0 
0 0 0 0 0 0 0 0 
0 0 0 0 0 0 0 0 
0 0 0 0 0 0 0 0 
0 0 0 0 0 0 0 0 
