NewRoom 3
0 0 0 0 0 0 0 0 
0 0 0 0 0 0 0 0 
0 0 0 0 0 0 0 0 
0 0 0 0 0 0 0 0 
0 0 0 0 0 0 0 0 
0 0 0 0 0 0 0 0 

0 0 0 0 46 46 40 40 
0 0 0 0 47 47 41 41 
0 0 110 50 48 48 42 42 
0 0 0 0 49 49 43 43 
0 0 0 0 0 0 44 44 
0 0 0 0 0 0 45 45 

0 0 0 0 0 0 0 0 
0 0 0 0 0 0 0 0 
0 0 0 0 0 0 0 0 
0 0 0 0 0 0 0 0 
0 0 0 0 0 0 0 0 
0 0 0 0 0 0 0 0 
