NewRoom 5
0 0 0 0 0 0 0 0 
0 1 1 1 1 1 1 1 
0 1 0 0 0 0 0 0 
0 1 0 0 0 0 0 0 
0 1 0 0 0 0 0 0 
0 1 1 1 1 1 1 1 

0 0 0 0 0 0 0 60 
0 0 0 0 0 0 0 0 
0 0 90 90 90 90 90 90 
0 0 90 0 0 50 0 90 
0 0 90 90 90 90 90 90 
0 0 0 0 0 0 0 0 

0 0 0 0 0 0 0 0 
0 0 0 0 0 0 0 0 
0 0 0 0 0 0 0 0 
0 0 0 0 0 0 0 0 
0 0 0 0 0 0 0 0 
0 0 0 0 0 0 0 0 
