NewRoom 2
1 1 1 1 1 1 1 1 
0 1 1 1 1 0 1 0 
0 0 0 0 0 0 0 0 
0 0 0 0 0 0 0 0 
0 1 1 1 0 1 1 0 
1 1 0 1 1 1 1 1 

0 0 0 0 0 0 0 0 
0 0 0 0 0 20 0 0 
0 0 0 90 91 92 0 50 
0 0 0 90 91 92 0 0 
30 0 0 0 22 0 0 0 
0 0 21 0 0 0 0 0 

0 0 0 0 0 0 0 0 
0 0 0 0 0 0 0 0 
0 0 0 0 0 0 0 0 
0 0 0 0 0 0 0 0 
0 0 0 0 0 0 0 0 
0 0 0 0 0 0 0 0 
