NewRoom 4
0 0 0 0 0 0 1 0 
0 0 0 0 0 0 0 0 
0 0 0 0 0 0 0 0 
0 1 1 1 1 1 1 1 
0 1 0 0 1 0 0 0 
0 0 0 0 0 0 0 0 

0 0 90 0 0 90 0 50 
0 0 0 90 90 0 80 0 
0 0 0 100 0 0 0 0 
0 0 0 0 0 0 0 0 
0 0 0 0 0 0 0 80 
0 100 0 100 0 0 0 60 

0 0 0 0 0 0 0 0 
0 0 0 0 0 0 0 0 
0 0 0 0 0 0 0 0 
0 0 0 0 0 0 0 0 
0 0 0 0 0 0 0 0 
0 0 0 0 0 0 0 0 
