NewRoom 4
0 0 0 0 0 0 1 0 
0 0 0 0 0 0 0 0 
0 0 0 0 0 0 0 0 
0 1 1 1 1 1 1 1 
0 1 0 0 1 0 0 0 
0 0 0 0 0 0 0 0 

0 0 100 0 0 100 0 50 
0 0 0 100 100 0 90 0 
0 0 0 110 0 0 0 0 
0 0 0 0 0 0 0 0 
0 0 0 0 0 0 0 90 
0 110 0 110 0 0 0 70 

0 0 0 0 0 0 0 0 
0 0 0 0 0 0 0 0 
0 0 0 0 0 0 0 0 
0 0 0 0 0 0 0 0 
0 0 0 0 0 0 0 0 
0 0 0 0 0 0 0 0 
