NewRoom 6
1 0 0 0 0 1 0 0 
0 1 1 1 1 1 0 0 
0 0 1 0 0 0 1 0 
0 0 0 0 0 0 1 0 
0 0 0 1 1 1 0 0 
0 0 0 1 1 1 0 0 

0 80 0 0 0 0 0 0 
0 0 0 0 0 0 0 0 
0 0 0 50 70 0 0 0 
0 100 0 70 50 0 0 0 
0 0 0 0 0 0 0 100 
30 0 0 0 0 0 0 0 

0 0 0 0 0 0 0 0 
0 0 0 0 0 0 0 0 
0 0 0 0 0 0 0 0 
0 0 0 0 0 0 0 0 
0 0 0 0 0 0 0 0 
0 0 0 0 0 0 0 0 
