NewRoom 6
1 0 0 0 0 1 0 0 
0 1 1 1 1 1 0 0 
0 0 1 0 0 0 1 0 
0 0 0 0 0 0 1 0 
0 0 0 1 1 1 0 0 
0 0 0 1 1 1 0 0 

0 90 0 0 0 0 0 0 
0 0 0 0 0 0 0 0 
0 0 0 50 80 0 0 0 
0 110 0 80 50 0 0 0 
0 0 0 0 0 0 0 110 
30 0 0 0 0 0 0 0 

0 0 0 0 0 0 0 0 
0 0 0 0 0 0 0 0 
0 0 0 0 0 0 0 0 
0 0 0 0 0 0 0 0 
0 0 0 0 0 0 0 0 
0 0 0 0 0 0 0 0 
