StartOne 1
1 0 0 0 0 0 0 0 
0 0 0 0 0 0 0 0 
0 0 0 0 0 0 0 0 
0 0 0 0 0 0 0 0 
0 0 0 0 0 0 0 0 
0 0 0 0 0 0 0 0  

0 0 0 0 0 0 0 0 
0 10 20 30 40 50 60 0 
0 10 0 0 0 0 70 0 
0 40 0 0 0 0 80 0 
0 90 100 110 120 130 140 0 
0 0 0 0 0 0 0 0    

0 0 0 0 0 0 0 0 
0 0 0 0 0 0 0 0 
0 0  0 0 0 0 0 
0 0 0 1 0 0 0 0 
0 0 0 0 0 0 0 0 
0 0 0 0 0 0 0 1 
