NewRoom 10
0 0 0 0 0 1 0 0 
0 0 0 0 0 1 0 0 
0 0 0 0 0 1 1 0 
0 0 0 0 0 1 1 0 
1 0 0 1 1 1 0 0 
1 0 0 0 0 1 0 0 

0 0 0 0 0 0 0 30 
0 0 0 80 80 0 0 0 
0 100 100 80 50 0 0 0 
0 100 0 80 0 0 0 100 
0 0 0 0 0 0 0 0 
0 0 0 0 0 0 0 30 

0 0 0 0 0 0 0 0 
0 0 0 0 0 0 0 0 
0 0 0 0 0 0 0 0 
0 0 0 0 0 0 0 0 
0 0 0 0 0 0 0 0 
0 0 0 0 0 0 0 0 
