NewRoom 10
0 0 0 0 0 1 0 0 
0 0 0 0 0 1 0 0 
0 0 0 0 0 1 1 0 
0 0 0 0 0 1 1 0 
1 0 0 1 1 1 0 0 
1 0 0 0 0 1 0 0 

0 0 0 0 0 0 0 30 
0 0 0 90 90 0 0 0 
0 110 110 90 50 0 0 0 
0 110 0 90 0 0 0 0 
0 0 0 0 0 0 0 0 
0 0 0 0 0 0 0 30 

0 0 0 0 0 0 0 0 
0 0 0 0 0 0 0 0 
0 0 0 0 0 0 0 0 
0 0 0 0 0 0 0 0 
0 0 0 0 0 0 0 0 
0 0 0 0 0 0 0 0 
