NewRoom 1
0 0 1 0 0 1 0 0 
0 0 1 0 0 0 0 0 
0 0 1 0 0 1 0 0 
0 0 1 0 0 1 0 0 
0 0 1 0 0 1 0 0 
0 0 1 0 0 1 0 0 

0 40 0 80 80 0 0 0 
0 0 0 80 50 90 0 0 
0 110 0 80 80 0 0 0 
0 0 0 80 60 0 0 0 
0 0 0 80 0 0 110 0 
0 0 0 80 80 0 0 40 

0 0 0 0 0 0 0 0 
0 0 0 0 0 0 0 0 
0 0 0 0 0 0 0 0 
0 0 0 0 0 0 0 0 
0 0 0 0 0 0 0 0 
0 0 0 0 0 0 0 0 
