NewRoom 1
0 0 1 0 0 1 0 0 
0 0 1 0 0 0 0 0 
0 0 1 0 0 1 0 0 
0 0 1 0 0 1 0 0 
0 0 1 0 0 1 0 0 
0 0 1 0 0 1 0 0 

0 40 0 90 90 0 0 0 
0 0 0 90 50 100 0 0 
0 110 0 90 90 0 0 0 
0 0 0 90 70 0 0 0 
0 0 0 90 0 0 110 0 
0 0 0 90 90 0 0 40 

0 0 0 0 0 0 0 0 
0 0 0 0 0 0 0 0 
0 0 0 0 0 0 0 0 
0 0 0 0 0 0 0 0 
0 0 0 0 0 0 0 0 
0 0 0 0 0 0 0 0 
