NewRoom 2
0 0 0 0 0 1 1 1 
0 0 1 1 1 1 0 0 
0 0 1 0 0 0 0 0 
0 0 1 0 0 0 0 0 
0 0 1 1 1 1 0 0 
0 0 0 0 0 1 1 1 

0 0 0 0 0 0 0 0 
30 0 0 0 0 0 0 50 
0 0 0 90 0 0 0 0 
0 0 0 90 0 0 0 0 
0 0 0 0 0 0 0 0 
60 0 100 0 0 0 0 0 

0 0 0 0 0 0 0 0 
0 0 0 0 0 0 0 0 
0 0 0 0 0 0 0 0 
0 0 0 0 0 0 0 0 
0 0 0 0 0 0 0 0 
0 0 0 0 0 0 0 0 
